type octile
height 50
width 182
map
......TTTT.@@@T.##T@.T.T@T@@TT.@..@@.T.T#.TT.#.#..@T#..@@##T@.T@.@.T#@@T@#@#@.T@T@.T#.T.T@@@@.T@#T@#.@@...T.TTT@@@T.T.T@#@@..@.#TT@#.....T..@TT@T@@..@TT@#@@#.T#TT@@...@T..T@..#.T@TT#
TT@@.@@@T@T@TT.TTT.@@#@T.@.TT@.T#T@@@T@@TT.TTT@T#T@TT.#T#T.TTT@TT.@..@T@.TT@#@T@.@@..@T.T.#T@T#.@.TTTTTT@.@TTTT.@TTT@TT.TTTTTT.#.@@T.#@##T.#T.T.#.@.TT.@.T.#@T@@.@T.#.T.@TT#.T.@@#TT..
.@T#TTT.@T@@.@.@T@...@@@T@T@.T@.@@T.@T@T@@...T.@@.T@@.T@...#T#T..@@T@...@TT...@.TTT.T@##..@.@.@@.T@.T..#.T@TTTT.@TTT@.@@#...@@@@@#T@@T.TT@#TT@@TT@.@.@@@T#.@..T@@@..T.TT@T@TTT#.@.T.@@
T@.#T@##.#@T@@T..@.T@@...T@#TTTT@.##T....@#T.T@@.@.@@@T@@.@.#@.@T@T@@TT.T.TT@T#T.T.T#T@#T#.#T@TT..#@@T@@@TT#...TTTT#@.@@#@....T.@#@@..TTTT@#@TTT.@@@T.TT#T@TT.#TT.@.@T.T@.T.#T.TT@T.T.
@.@@TT@@.@@@@.T@TT..@T.#TT@@.@.T@#@T@@.TT.@@.#....TTT.@@#..T#TT...@T.T..#T@T.T...@TT@.##.TT..T@@...T#T.@T@T@@..TT@T@@T.T@@..@..@.T.T@T@T@@.T..T.@@TT.@.T#T.TT.@..#.@T@@.#@T@...@TT#T@@
T@T@@@T...@#T...T.@@.@@#@.T..@TT.TT.@@.T#T.T@.@#.@T.@@.@@.TT.T@@T..T##.@T@@@T.@@@.TT@T@.#@.@T#@..T@T#.@@@#...T.T.T.T....T@T#TT@..T#@.TTT.T@@T.T@.T...T..T@@..T.TTTTTTT...T@@@...T##T#T
...@@.#T.#...@.T@#TTT.@T#T@@..@.@@TT@.T..@..T@T..@@T@..@.@.@@TT..T@@#T.@..@.@@@T.@T@@@@#.TT@.T##..T.@#T.@@.#.##T#TT....TT@T#.@#..@@T@T@..TT@.@TT@TT@@@#T@#.#T@TT..@...@TT@.@..TT##.@@#
....@...@.TT..@TTT@T.....@TT@@.@@.@T@.@.@@.#.T..T..T@TT.@TTT..@#...@@..T...@@@@T..@#T@T#..@.@T#T.@.@TTT.TTT#..@.@TT@@@@T@@@T@T@T@..T@.T.@TT.@.@T..T#T.T@@@@T..@..#T.T.#@.@.TT@TTT@@.@#
@@T@@T@.@.@T@.T@#T.T@..@T.@@@#T.@@.@@@#.#T@..@TT.@T@@@#T@@.@@T@...#T.@.T@@.TT@.T@T@@T.@.#@#.#.@.T.#T@.TT.@TT.....T.TT..@@.@@T.T@T#.T..@@T.T#@#.@TTT.T#@@@T..###TT.@...T...@T@@..@..T.@
..#.T#@..TT.#.@T@...@@@@..T@#T###.#@@@.#.@T@@@.@T..T.TT##@@T..TT@T@#.@TT@T@.#TTT@@T..@.@T@@#@T.T#@....@....TT@.@#@@@T@T.T@T.@@.T#@T.#@#@T.T#T.@T#T#T.TT@..T.@T.@#@@T..T..T#@T#TT@T.T.#
T#....T.T....@TT@@..T@.#.@.TT@@@T@T.@..#T.@T@@.@@#.@@.@T@@@T..#@TT.@@TT.T#@#TT#@#@T@TTT...##TT.@.@@##@TTTTT@#T@T.TTT@TTT@.T@T@@@TT@T.T.T.TT.#..TT@T@TT.@T@TTT@@@T@T.@@T.@TT.@T.@@.@.#@
...T..@@@.T#@@...T..T@@@.T@T@@@@TT@@T@.T..@#T@..T..@##..@@T.TTTT@@#@#.T@@..@.@@TT.TT#@.T#.@T...@..T@#T@.@##.@@@.#@@..TT#.#T@..T@@TTT.@@..TT@@#T#@@@..T@TT.#..TTTT.@...@.T@@@@@.TTT@T@T
T.TTT#T.T@.#TT@@T@@T#.#TT#.T.@@@T.@..#.@.T#@T@@.@@..@TTT@..#.@@......T@T@#T@@......T@@T..#.T.@@TT@@@.##@@.T.@.T@@.TT@T#TT@@.@@@@TT..@.@.@@T@TT.T.T@.T@.T@T.T.#@@TT..@.T@.T@T@#@.TT@.@.
.#T@@..@@.@.T.....#.@.T@.T@.#T@@@.T@..@.@T.T.@#T@@T@@....T@@#TT.@...@@#.#T.@#.T@..@@.@.#..T@TT..@@.@TTT@.T#@@@@#TT@@.T.@@@T@..@.T.T@@@.T@@T.T@.@TTT.T#T@@#T.@@T.@.#@.##@.@T.T@@@TT.T.#
TT#T.#@.T@T@##@T@.@TT...@.@TT.T.@@.T#@@.T#T.T@..#.@@@..@T@T##...T@.T.@T@.T@T@@#.@T@.T@T@..@.#...@.@#@@@..TT#T@@@.#T@T@#T.#@.@T.@.T@.@@@#.@@T..@.@T.TT@T.@@TTT@T@..T#.TTTT.T.##.#@##.T@
@#...T.@.@.@TT@TTT.@.T@...T@.T#.@.TT.#TTTT..TT@TT@#TT@#.@.#T@T.T.T@TTTT@.#.T@.@TTT@@T.T.TT.TT.@TT.@T#TT.#..@@TT#.@...@.#.@T.@@@..T.TTTT..@...@T@TTTT@TT@@T.T.@@..@@T.@TT.@.@..@@@.@..T
@@#T.TT@@TT.T..#TTT@#T.@T...@@....#..@.@T.T@T@#T..TT@@TT..TTT.T...TT.@@TT#T@.#.@TT@.@T@TTT@TT@@.T#@TTT.#..@TT.T.#@T@#TTT.T@..T..T#@T..T#T@T.#@T.@T..@@..TT..##@@.@..@TTT.@....#TT.@@@.
@.#@#@@.#.#T@...@T...@.T@..#@.@.TTT.@@T.T@#@.T#....@T.TT.@@TT##.#.#@@..TTT@T@.TT@..TT@T#TTT.T..#...TTT.T.@##.@TT@T@@@@@TTTTT@.#@T@#TTT..TT.T.@.@@..T#.T@TTT@.@.T.@@.T@@#T@@...T@T.@#T#
@T@T@T@@TTT@@T.#@T##.@@.T@#T@@@@T#T@TT@.TT@T@@#@@@.T..@T.@TTTT.T@T#.T@@TT@@T@@@.TT.@...@.T@@T@T@T.T....T@#TT#TT@@.T.@@...@@.T@.#@.@T#@@.#TTTT@TTT@..@T@T..T#@T@@@..@.#T#..@@.T.@T@T.TT
.@T##@T.@#.##T.T.@@#TT@TTT.@.@.@.#T.#@..TT.TT@#...T..@TT.@.@..@..@#@@.@.T.TT@T.T@@T@@@#@@@T@TT@@.@T..T.##@#@.T@.TT.TT.@#@.#...#.@.@#TT#T#TTT@......T@@.@@T#.@T.T@.T@..@.@.@..T@TTTTTTT
@T..@@#T@@.T.T@@.T.@.@.T.T@T@@#@@TTTT.@...@T...@TT..T@.##TTT....@.#@T.@T@T@@@TT...T@@.@@#..##.T@@...@T.T@@TT@.TT@@#.@@#@T@T.@...@@T...@#.@@T@T.T...@TT@@#T.@.@@T.T..@#.@TT@.@@.@.@T.@@
.@TT@T.@#T.@.@TT.@T@#T.TT...@T@T.@...TT..T..T@#@@@T#@TT..@@T.@T@@..T@@#T.#T@.TT@.@@T.T#T..T@.T.T@@#T#@T@TT#T@.##@##@T#T#TT.@#.TT@#@.#@.@T.T.@@T#.@.T@@T.TT.T.@..T...#..T..T..#@.T..@.@
T@##@@.TT@#TT@.@@T@.T@.@@T@.@.....#@TTTT....T@@T@TTTTTT@#T...T@T@.@.#@@TT@@@.@T@@...T#.T@.....T@@TT@@@.###T@..T@@.@.TT.@@@...@.#T.T@@@T@#TTT...@@@@@.#@#T#T@#@@T.@@#@.T.@.TT..@TTT#T.T
#.TTT.T.TT.@..@.@T@@T@@.#.##T#..TT..@.#@TT@...T@@@T@@#@TT#.@TT.@T@..@T.@@@@T@TT@@TTT@@TT#T..TT.@.@@T#@@@TTTT..T.@..T...T#T.@.TT@@T.TT@@@.##.T.#T#.@.TT@.@TT@T@@TTT..@.#@@T.TT.@@TT.T.T
.TT@#@..@@@...#.@@..@TT@TT.@#@T..@@#@TT#.@@T.@T@..TT.@@@T@.@.@@.#TT#.T#T#@T..T#.T#@TT#@TT@.TTTTT@.@T@..T....TT..@@...TTT@.T@.@T.T.#@@.#.@.@.@T@@@@@.@@.@.@.T@TT@.TT..@.@T@#@...@..@@@T
#T.TT@....#T.@#.@@@@@TT.#TTT@..T##@T@T...TT.T@#..TT.@@..T@..TT.T@@..#..TT#@@T.@T..TT@TT#@@T.T##T.@@@@T#TTT#TT.T#T.T#@#T..@@T....T.@T#.T@T@..T.@@#@#..@@@.T..@T...TT.TT#@@.T.@@.@TTT##.
T@@#T.@TT#T..T@@@@TT.#@@T@TTTT@TTT.@..@@T.@@...T.@..@...#...@#.@@#..#.T@T@.#.TT@#T.#@##.@TTTT#.T@.@TT.#@.T@@.@..@@@T.T@@@@#.@@T.TT.@@@T@@T@##..@TT...T@T.@@T..#TT.TT.TTT.@..@#@..T.T@#
T@.T.T.T@#TT..TT#@.#..TT..T.@T.TT#T..@T.#T##.T@#..@TTTT@..T@@@..@##@TT.TT.@T..@.@.@#.@.T@.@.TT@T@..T@#@.#T@@TTTTT@T..T..TT@..T#T.TT#@..@..T@TTT@@TT#@@##.@..TTT@@#@@T@@T.@@#TT.T#@T@@.
@@@T#.TT@.@#T@..TT@#T@@.@...@#@T@@.T#@T@T.#T..#...T.T@.@.T@.@@#@.@#.TTTT@....@.T.T@@@TT.@..@#@.@@@@..T@TT@.TT@@T.......@TT..T@#..#T@@T@@@..@@TT@.#@@...@..T#@T.T@@@.T..@.@#TT.@.T.@T#.
.T....TT@T.T.T#@@.TTTTTT@..T.@@T#@.TT.T@.@#T.@#..@...TT.TT..T#TTT.#..TT@#.@@#T@.T.TT.#.#..@##TT@.@..T.TT..#T#T.TTT.T.....@@.TT#@TT@@.T@T.@T.@..@..TTTTT.....TT@@T.TT@T.T@@.@@.@..@.@.T
TT@.@@@#.@@.@T.T@...@@@@@.@TTT....@TTT@T#@TT#T.T.#@.T@@@T#@@#@@@T#@.@.@.T.@@T.@TTT@..T.@TT.@.@@@T.#T#TT.T#T#@@@.T.@T@.TT.T.@@@@@TT.@..T...T.T@T##@.TTT@.T#.T...#T@@@@.TT@.TT..#.#TT@T.
@@#....@#T.T.T.T...@.T@.@.T#@@#@#@T.@TT@..TT..#@@@#.@@@..@@@T@.@.@T#@T@#T...TT@T@T.T@.@T.@.T@.@.@T.T##T@@TT@#@@@TT@@@@T.@TT#T@@@@T@@#.@@@@.....T@T@@@@.T@.@@TT@T@.T.T@.TTT@@@TT..T@T@@
TT.TT@@@#T#.@.@T.@@#.T#@TT.@T.@#..@.@.@#@#T..@T#TTTT.@.@..TT..TT@@T@TT@@.#.T.#TT@@@#T@@T@T.@@...#@..TT.@.#@@@.T#TT.@@..@T@.#@.T#@#@.#T.T@.T@T.#.@T.#T.@@#T@T@T..TTT#@.#T@.#@@T@@...T#.
@@#.TT@@@@..T@TT.#@@@T.T@@T#T@@#T.@@.T@##T.TT...@@#@....#.@.T.###.@@.#@..@@@T..#@@@@.@@.TTTT@@@TT..@@T.T..@@@@T#.T.T@@TT.@@.#.TT...@T.TT.T@.T@.@.T@T...TTT.TT@@.@@TTT#..@TT.#.T.@.@@TT
T@.@@.T..@@##@@#.@@..T@T@@....@T@@@@TT.TTT@.@T..@@@T.T@.@@#@..@.@.@.#@T@T@@@.T.TT@..TTT.@@@@T@.T..@@.@@T.TTT.#@@..T@T#@T.@..TT.T@@T#...@T#T@T.@..@T@.@TTTT.@T#TTTT#@@T.T.@@@...@.TT.#@
.@@.TT#T@T@.@.@T@.@T..T#TTT..@T..TTTT@@.#T...T@T@.#TT.TTTT@@T.@T.T#@##@T@@@T#T@TTT.T@.T@TT@..@.T@...@.T.@@@...T@#T@@T....@@.#@@#....@.T...T.#TT#.@TT#@@T#.@.@@TTT#T@.TT.@.@.T@T.T.T@@.
TT@T@T.@@T.TT.#@@@T#.#T..@@.TT@T.@T@@TTT@@T.@T.T.T@..T@.T#@@T#@@T@#.#T@T.@@.T.@#.@T.@T#@.T@.TT#@T...@.TTTT.@T.TT@....@.@.T@.@@TTT.#T##TTT@T.T.@#T.#TT@##.TT@@@@@..TT.T..@@@..@T@.@TT@T
TT.TTTT@#T.T@.#T@@.#TT#T..T..@@TT.T@@@@@.T.@TT.@..T@@..T@@#T.@@@TTT@#.@@##..T@#@@T.@T.@@T@.@@@##@T#.T@.T@...T.@..@TTTTTT#@@.@TTTT@TTTT..T@@.T..T..TT##TT@#@TTT.@@T@.@...T@.T##TTT.T..@
.#..@@#@.T.@....TT@T#.@.TT##@T@.@T@#@@.T.@.#@@.@T.@TT.@TTT@.@T.@@.T.@.TT@@@.T.@.T@#T#T@.@T.TT#@.#T.@##@@...#TT.@@TTTT@#T@.@T.#TTT.@#TT@..@T@T#.TT#..TT@#....@@TTT@T..#@.#.T.@@TTT@@..#
.T...TT@@@@TT.T.T.@@..T.@T..@@#.T#@TT.@@T@@@.T..#T#@.T.#.TT@..@@.@@T@.T@@..@TT.@#.@..#@..T..@...@TT@TT.T@.@#..##@@@@##...TTTT.#T@.#.T#..@@#.#..@TTT#..T.T#@#.TTT....TT@.T@..@.@.TT..#.
..@TT@@##TTTTT.T@TT.TTT@.T@T.T.T.@@@#...T@...T#.@T.@#T@T@...@...T@@@TT@@..#T@T#T.T.#@@#T@#@.T.@TT@.@.@@T#..T@.TTTT@T@..T@T.@@TT.#.@#.@.TT#@T@TT..T@@.@@T@.@TT@@T..##T@@T.@T@.T.@.T.T@.
.@T#T@#T.T.T.@..@T@.@.T#@@T@T@##@..@.TT@TTTT@.@TTT@@T.T#T.TT.TT#.T.@TT.T@@TT@T.TT#T@TT#.@TT@@@.T.@@...T.T@@#@@TT@TT@T.#@.#.#T@@@..T@@..@T@...T.@TT@..@@.TTT@.T@.#.@@.TT@.TTT#@.@TT@@TT
@.TT@..@@TTT#.@TTTT#@@.@T#@..@..@T..@.T.T.@..@@@..@T.@.@.TT.TTTT@T..T@@@.T..T##.@TT@@.@.@...T@T@@#@@TT.T@@.@...T@...@.@.@@.TT@@.@.TT@T.@.@T..#TT@..@#T.@T.#.TT...@.@T@@.@.#T#.@T.@TTT#
.T@.@@@@@TTT@@@TT#@#@@@T@@#@T@@@@TT@.@#TTT..#T.@@.TT.@TTT@@@T.@@T....@##@T#@@T@.@.TTT..T#.@...T#T.TT.T#.@.#T...T@T....T..@@@@T@@.#T@#@@#T@@..@...T@T###T.@..@@@TT.TT.T##@@T@@@.T@@.@@T
T@.TT@..@@@T#TTTT.#T#.T.@T@@.T...@#..#....@#T.@T#.@T.T#@@@TT..TT@#@..##T@T@@T.@T.T..TT@.@TTT@....TT@.T.T@T.@@@##@.#@T@@.T.@@.@.T...T.@....T.@T@@..@...#.TT.@.@..@@.@.@@.@@TTT#@@@T.@@T
@T#@.#T@TTT@.TTTTT#.@@T@@.@@T.@@.TT@TT..@#TT#.TT.T..@T@@TT@#@#@@T@@@#.T@TT..@@.T#.T@T@..@@T.@@T.@@@@#.@#T@.T.T.@TT.@TTT@.T.@.#@.@@.T#.@@T@@T.T.@@#T@@@@.@.#T@.@@@.@@TT.@T.T.#T#TT.....
T.@.@.@T.T.@@@T@.@T@T.T.#@@T@..T.T@@T@@#@.@@@@TT@#@.@@..T@.@...@T.TT#..T@T..TT#.@T@@TT@TTT@@@..@@@@T@..@.@T@T@..T@.#T#TT@T.@@..@..T.@.@T@#.@T..TT.@.##.T.T.T...#TTT#TTT@@.#T..T.@..@.T
.#@TTT#@.T.##.T.T.@.@..T@TTT.@@T#TT.@##.@@@.@.T.@.T.T@.@T@TTTTT@@T@@T.TTT@T..@.#@.@@T#T.@.TT@T#TT.#.T#..T..T.TT@TTT@T@@TT@.TT..T@.#.T@#@.TTTT.#..@@.@T.TT@T.T.T.@@T.T.T@T.@@@T...TT@..
.T@T@T@@.@@@TTT@T.@@@@.#.@..@..@T@.@@T@@T@@.#.T.@TT@T@.T.#.#..@.#T.@T..@@T#T.@..T#.@T#T@.T.TT@#.#T@@.@#@TT.TTT.T.TT.@@.@.@.TTT@TT@#T@##T@.#..@T.@@.@TT#.@TT@TT@.@@T@TT@@...TTT@.@.T@.T
TT@TT@T.@T.TTTT.T.@#T#@..@@@TTT..TT..##.@@@.@TT@.@T@@@T@TTT@@.TT.T..@.@.@@@#@@#.T@.#.#@.@#@TT@@.T..@#..T@T@.@@T.@@@T..TTTT@TT.@@@#@@TTTT@#@.@..@.@#.@T@@.@@#T##@@..@@#..TT.TT@..T@@TTT
