type octile
height 100
width 182
map
@.....@@.#.@#@@@.@@@..T@T@@...@@@@.T....@#.@.T@T@..@..@...@TTT#.@@T.T..@T.@.#.##.T#T@T.T@TT.T@.T...T@@TT@.@##.#@.TT@@@..@T.T...@@#.T@.#@#TT@#T..@T.T#.T@T.TTT.@@T.#@@T.@T.T@T.T#T.TT..
#.T.TTT@@#TTT#..@#T@.T@.@.@@...@#@T.#T@@T##.TTT.T@@TT#TT.@T@T#T.TT@T@.T@T.@.@@@TT.TT@@@T..T@.TT@@TT@@.@@@@TT..@.T.T@@@@TT..@@.T..T..T@@@@#T..@T..@..T.@@T@....@@#TT..@T.#TT##..T.@.@@@
T#T@T@@@T@@T@@T@T@.@@.@T..@T.T@.@#TT@@T.@.TTT@@@......T.T@T...TT@T...#@.@TTT@#..@T@@T#T.@T@.T..@T@#..T@T@TT@T#TT...T#@TT.T.@TTT@#....@@@#@T.@@@@@TT@.T..T.T.@.#TT@T@T.T.@TTT@@@T.T@@@T
...T@TT@@@..@@T.TT@.TT.#T.@#.@T@T@T@.T.TT@T#.T@#T#.@@.@T..@.#.TT.@.@.TTT#....TT@@TT@T.TTT@@@T@.#TT@TT@.T@@T#.@.@.@@T@@.T..##TT@.TT@.T.TT..#TT#@..#@#T#@@.T#@T@@.@.T....TT.TT...T...@TT
..@@TT@@@@.T@.T.#TT.@TTT@#.@TT#T@TTTT@T@.@#@TT#.@T.#@.TT@#@TT@.#@TT.@..T.@T@.@.@T.@@T.##T@@TT#T.@.@TT#.@.##...@#T#@.TTT..@TT@@T@TT@@.T@.#T@TT#.@##T.#T.T#TTT.#@#TTTT#@@@..@@@T.T@.T..@
T#TTTT.T#TT..TT.@.TT@@.#.#TT.T@TT.@.@@.TT#@.T.TT@#.#T.TT#.#T@@T@@@.#...T@.T.T#@T@TT#.#..T@.T.@.#T.@.@T.T@.@...T.TTTTT@@#..TTTTTT@TT@TT@..T..T@@@@T@.T@.TT##TT..@T@..T.@@T@.T@#@TT..TT@
..@T#TT@T@@@TT@.T@.TTT#T@T.@..@......T@T.T@.T@@@#T.@@T@..T@T@.@@#T.#@T.T.@##..T#...@#.@T@.#@@TTT@@.@@.T@@T..@T@.T@@##@.T.TTT@##@..#@T#@T.@@@@...@@.#@@#.T#@@@@T#@@@T@#...TT@TTT#TT#@@T
@@#TT...T@#..##T..T.#.@.@#@@@@.@.T#T@T.@T.@@##@T.TT#@@@@T@#..T..@T@.@T.#.@.T@.@T.@TT...#T@.@T.T@.TT@@#T#.T@@#@@.@@TTT@.T@..TT@T.@@###@T@#T@...@TT@@.T##T.@@..@@@@@..@..@T.T.#TT..TT@.@
T..@.TTT@.@@@@@T#@T..T@...@TT..T@#.T@TTTTT.T@@.T.T..@..T.@@T@TT..TT#@T@.T##T#@.@.@#..@@.#@#.#TT.TT##@.#T@T.@T.@@T@@TTTT.TTT@T@@.@.###..@@.@@TTT.@@..T#T..@.T#...@@#@@T##.T@T..T.@T.TT@
T.@.#@.@..@T.T.T.T.T..TT@@@T@##.@@T@@@TT@TT##@@T@.T.@.@#@@@@@.@@T@@.@@TT@T#T.T@@.@..TT.T@T@T@T#T.T#@#@@.T@T@@T.#T.T#T#@@TT@.TTTTTT@#.T....TTTTT.T@@T@@.@#@T.#@#.@@@T@TT@@.@TT.TT#T..T@
.@.TT@.TT.@TT.@#....@@@.@T.#T@T#TT@#.@.T.TTTTT@@@T#TT.T#T.@.T#TT.##@@@@.#@...T.T@T@TTT#.@@TT#T.TTT@..@T@T.@@@@#.@TT@T#.#TT.#T#T@@TTT@T@.#..@@@T.@@TTT.#.@T@TTTTT@@T..T.T#@.@T#T@@TTT@.
T@.TT##TT@..@@T.#T.@.@@T#T.@@T.#@T..@#T@..@@##T#T.@@@T@..#@T.@@@@@@.T.@T..@.@T.TT@.#@@T..T.TT@..TTTT@@.@TT@T.#@..T...@@.@@T@..@TTT.@@T@.T.T.T..@.T..@#@.T@@..#T@T.@@#@@@@@@TT.#T.@..@#
@.T#@..#TTTTT@@T@.@T.@@.@@TT@....@T.#.T..#T#@.@.#.T@@T@@..T.@#T@T.T.TT.@TTT@T@#@...@#@...#@@.TT#T@.@@TTTTTTT#@.#T...@T..@T@.@.@..@T@..T#.T.T@T.@T.TT#.@T@TT@#@@.@@T@@T.@...@#@@T@.@#@@
@.T.T..T@..T.@@.@T.@T....T...T@#.TT.T.T@@.@@.@#@#@#T..@.#T@@T#@..TT@#TT@.T@#T.@...@@.T#T@@@T#@T.@#T##@TTT.@...#TT.#T#..#..@@...@.T#.@T@.T@TT.#@T@@T...#.T.TTT#T.@T@@T@@T@.@.T@T@..@T##
T.T....@.@TT.@T.#T@@.@@.@TT.@@TTT@@TT.T.T...@T@T@.@T@.T@##T@@.@#.T...@T@.TT.@T..T..#@.T.@...@@TT.@.@T.@@@.@.T.@.@#@@TTT.T.T@@#.T.#.T#T.T.@@.T@@.@...T@.@T@T@T@T.#T@..@#.TT#T#@@TTT.T@.
T@.@.T@@T.TTT@..TT@@#TT@@.TTTT.@#@.@T..T@@T@@T@TTTTT@.@@.TTT.#.T@T....T.@#TTT@#@...@@T@.@T.@@..@TT@T@@T#T@T@@.@#...T...T@@T.T#@.TTT@@T.#..@#T@.@TTT.@.@.@#.@TT.T@@@@.#T@.@.@.##TT.##TT
@#TT#.#@TT...T@#.@@.#TTT.@..@T@@@..@@@T..@T.@T.@@@@T..@..#...@@@#@TT.@#@@@T@@@T.T.@T.TT.T#T@.T@T..@@@#TT@@T.@.T.@@TTT@#T...TT.T@T.@..T.@.TT.TT@@@@@#@@@#T.##TTTT@##@@.T@@T@.@..@.T.#..
.@.@.@TT@T@@@T.@T@@@@@.T#@.TT.#@TTTT.@#.#TTT..T@..@@T.@#@T.T@#...@.T..@T.TT@@@T.T.T.T.@@T@TT@..#..T@T.@..T#..@@T@@T#.#.T...T..T.@@.#.@TTT.@T@#T@T.T.@T@.@@TT@@T.@@T.T.TT#@.@.T@@@...#.
.@.#@..@.T.T#TT.T@@@.T##T#.#.#T.T#..@..#T.T@T@#.TT@.@T###@TT.T..T##..TT@T.@@@T.T.T.T@@TT.T.@#T.@.TT.TT#.#.#@TT.T.@TT#.TTT#.@.@T..T@TT#.@......T..T.T@.@@#@T@TTT@#@T@@..##@#@.......T#T
TT@TT@.@@.T@@@@.T@.#@TTTT.T@..T..@.@....@@T@@.#T..@#@..T.@@@@TT..T@@T.@@.T#T.@@.@..T.@#.@TT@@...T@@T@....@@@.T........#T#.@TT...@T@T@..T@@T@#.@.@@@#@@.T..@..#.@@@.T@@T.@.@@@@..T@.T#T
.T@#..T.@#.@@@.@..T@T#T.@.@TTT.@T..@#..TT.@..T..T@@.@T.#.TTT@..@T.@@T#@.@T..@#@.TT.@T.T@.@T.#@..#@##T@T@.#T@TT.@T.@.@....T..T.@T#..##..#..T#..@@..@.T.@T.T@@@TT@@#.#@..#T@T.T.TTTT...@
..#.@TTT.@@T@.T.#.@#...@.@.@@.T..@#@@#.#.T.#@@.@@..@.@@TTT..@T..@@@.TT.T..T#@..@T.TTTT@T@@..@.TT.TT.#T..#@#@@T..T@T@T.@.TT@T.T@T.#.T.@..T@.T#@TTTT@@@@@@T@@@....@...T@.T##TT#T@#TTTT.T
.@@T@T.@.@T@.TTTTTTTTT@#.@T@@.##..##.@TT##T.@T....T.@T@TT..#.T@TT@T.#T.@T@@T@..####TTT#.TT@@TT#TT@#@..@#.T.@..TTT.@@.@#T..@##TT.T#T.@@@.@....T@@@@T@T#.@#T@#.@#TT@.T@...@@T.T.@.T.TTTT
.@.@T@....TT@@T@.TTT..#TT..@.TT#T@T@@@T.TT.#@#...@TT@@@T#T.T@.TT.TT@#T@T.T@.T#.TT.@@T#@@.@#T@@@#..T@@.##@.#T.@@.@.T..@@...@TT@#T#T.TTT.#.TT@@@.T@T#T.T@@T.TT@@@#.@TT@..T..@@T@TT@T@@.@
T.@#..@@.@..TT@..T@T.@T.T#.T.@#..@T..T@.@.@TT@...TT@T@T@T.@@..TTT..##T@@@...T@.T@T@.@TTTT@.@T...T@...TT.@..@@.@@@@...@T..#@@.T...@@@.#.T.@#@.TT.@T.#T.TT@..#@T@@.@.@TT@..TT@@.@TTT.@T@
T@@#.@@.TTT##@@T.T@@@T.T@@TT@.T@T..@#T@.TT...@.@T.T@#@#@.T#T@.T@.@@@.T.@@T@TT.T@T@.T@..TTT.@..TT@.T.T.T.@T@.T#T.@.T.TTT...T.@@.@T#..T@@T.@.T.@T@.@#@.@.@#@..#@#@TTT@T...TT#.#.@TT#T.@@
T##...T.T...@#@T@TT@##T#.#.@@.##@###.#.@T.@.@.@@@T.TT#@@..@.@@.#@@..@.@#..TT@.T@#.@@T.@@#@#T@@@.T@@..@.TTT@.@#@.T@#@T@TTT@@@.@...TTT.T#.T.T@@#TT.#.#@@.T.T#T..@T.T@@TTT..T@@..TT@.@@T.
T#@@T@...T..#..@@.@T.@TT@#..#.T#.@.T@T.TT#@T@T@@..T.T...T.T.@#@@@#.T##.T.T@@#TT@@T.TTT.T#TT@@T.#TT@T@T@T.T@.T.@.T.@.@..#@@T.@.@.T@T@T.@@@@.@.@@@.TT@TTT.@.@@..TTTT..TTT@.@T#T..TTT..T#
..T.T.T@...##.@@@@.TT@.@..T@.@.TT@@..@@.T@T@..T#T@..T.TTTT@.@@T.T.@T..#T#@TTT.T@@.TT@TT@@T@T@T....@T..T.@T#@T.@@@@..T@#.#T.@#T@TT@T@T.@@@@T.@T@.@....#T.T@.##T@.##@TT.#TT..@#TTT.#.T#.
TT@#.#.T#T.@T@.@TT.@@T.TTTT@.@.@@.T#@T.@..TT@.@@@@T..@..T@@T@TTT#T..@@T.TTTT@@@@.@.T@#TT@.@#@.@#T#T.@@@TT@@...@@@#...T@@T.@TT...#.@T@#@#.@.TTT@@#.#@@@.T#@.@@T@@.@@@#..@@.@T..T..T.@@T
T@@.TT#.#.@TT#.@@@##@@.T@#.T.TTT##@@T@.T#.TTT@#@@.T.TT#.T..@.TTT@T.@T.@.@.T@T@@T....T@T..@.TT#@..#T@T@T.TT@T..@##@@..@T.T...T.#@T@T@...T...#T@..@.@@@TT@@T@@.#T@..TT.@#.TT@@T@#T@T....
@#.TT..@@TT.TT..T.T@T.@@@TT@#T@T.@T@#T#T.TTT..@#T#...@@@@..@TT#TTT.#@@TT#@@@@@@T@#TT.T#.#.@.@.TT...@@T@..T@...@.#..T@T.@@T.@TT@.T@.#T@T@.T@@.T@@.@#TTT@..@.@.@.@TT.T#@#T@@...T@T.T@T.T
.T@@@..@TT@@TT@@@T@.@T.T@T@..TTT.@T@@T.@.#@T@T@.@#@@...#@.T@T@@@T@#@.@TT@T.T@TTT@.TT.....@T@@T#@T@.@#@.T.#@@TT@#@.@T@T@@T@T@T@#..T@@#.#@.@@..T...@@@T#@##@@T#@..T@T@#.@@#T@@.TTTT@.T@@
@.@T@#TTT#T.T.T#T..#.TT@.@@TT.T..TTTT..@@#.T@#.@.@@.@@T#.#T.TT@T.T@@@@..@T.@@.@T@T@.@@T#@TTTT@@.@@##..@T@@@#@TTT..@#.T.TTT.@@...T@.T#.@@...T@@.T.@@T.TT..T..@.TT@T.T@.T@@.@T..#.T#TT@@
@T@.@..T@.T..#T@.T#@..@T@TT.@.TT..@T@TT.T@T@@T@...T#TTT@.#.@@@.@@T#T#@T#@@T#@.@@.T@.TT@.@@TT.@@@TT.@.T#.T#T@@.@..@@.@@#@#@#T@TT@@#T@@@@.TT@@T#.@T@@..#@T@T#T@@T..T@@@.#@..T..T@@..@.@@
@@@@@.TT..T@@@@TT..TT..@@#T.@T@.#@TTT#@T.TT.TTT..T@.TT@T@#TT.TT@@.@T...T@T#@.T.@@#TTTT@@.TT.@@@@.@#T#.@.@T@@@TT@..@@.@@.#...TT@T#@.@.@T.@..T@T#@TTT@.T..@@T.@@T.T@.#.#@@@TT.@@TTT@T..@
#..@.TTT@#@@@.###T.TT@#.T#@T@.#T...TT#@@#@#.T#T.@#T@TTT.@..T@.T.@@@TT.T@TT@#T.#.@@TT.TT.TT@@T@.T.TT.@.T..#TT@T.@@..T.T#.T@T#T@.@.@@.T@.#@@T@.#TT#T@@@@.T@@@.@T@.TT.@.TT...@@@.@@@@.T..
T@T.TT@@.T#.#.@@#T@.@.T..TT@#T.TTT...@@@..TT@..#@T..@@.@.@.@#@#@#@T.TTT@.@TTTT@T@..@T..T.TT@TT.@T@@@@T@@TT@@T@T@T@T@TTT@.@T@@.TT..T..@T@TT#.T.T@T@T@TT@@.T@T#.T@.#@..T.@@T@.T@@##.T@T.
T@...@..@@...@#T#@T.@.@@T@@@T@@.@@@TTT#.@@@T.@#.T.TT@TT.@@.T@.@T.T@.T@.#TT#TT..T#T@.T.@@@.TT..T.@#.@@T@T#@@TT@..TTT@.@@@@#@.@T.#TT..@T..T@@..@T..#TT.#T#..TT.T#@@.#.T@T.T#@T.@@@@#@@@@
T.TT@@TT.T#T.TT.@.....T@@T..#.@#.T.#.@.....T#TTTT.@@#@@T#...T.TTT@T@#@.@.T#TTTT#T@.#TT@.T@T@T##.#T#.@@TT.@.@@T..#T@@@@.#T...T.#.T..@T@@@#T#...@T@T.@T..@..T#T#TTT@.@#@@.T...TT.TT....T
TTTTT#@@@@T@T..@.#..#.T#T.TT.TT.T.@@#.T@TT@TT.#@@@@@@@.@.TT..@@@#.T.@#T..@@@......TT.@.@.@@@@TT@...T#@...T@.@.@T@T@@@TT@..@.T#T@@.T@@@T..@@@T.T@@#@T.#..T@#T.TT@.TTT..T.T.T#TT#T.T@TTT
T@T@T@.@...@@T@@@.TT.T@@TTT#@.T.T.@T.T.@TTT.TT#T@.....T..T@.@@@T...@@TTT.#T.@T.@#@@@.TT@@T@#TT##@.T.@@TTT.@T.T@.@.T.T.TT@TT@..@TTT@@.@..TT#@.@@..T#@.T@....@T..@@.#.T@@@@@@T..T@.TT.@.
T@.@@..T..@T.T@@.T@#TT..@@@.#@@T.@@T.T@@T@@.@T@.#...@@@#TTT@@T.#T@TTT#@.@@@@#......@.T#@@T#.@@T...T@TT@..@...TT#.@@@@T@@@.#@T.T#@@@..@TT#@T@@#T@..@T.@T@TT#.TT.#TT@#TT..T@T...T@@.T.@T
@@T@@..@@@.@TTT@T@@.TTTT#@@.@@@#T#@T@@@T@.#@@@@.T..@##@@TT.T.@..T.T.@@..T@.T..TT@@@TT.T@#..T@T.@@@@.@@.T.@@.#T@@.#TT#.@.TT..T#@.@....@TT...@T@@@.@T@.#TT#@T#@..@#.@..#...TT#@@@@@.T#.@
@.@@T.T@#.#@....@@TT.T@#@TTTT@TT#@.@T..TTT@T#@@.#.TT@#.TTT..T@.T.@@.TT.T.@#@.@T..@@.#.T.T@.@@TT.TT@T@T@T@@..T@@.@TTT@@T@T@T.#.T.T@T..@#...@#@..T.T##@.@..T@@@.T.@.@TT.#@@...T..T@@T#T.
#..@@T...@.#T.@@.T.T.#.T@..TTT@T@@..#@#TTTTT@TT..TT@T...@@.#@.T@T@T..T.@@@T@T.@@T#T@T@@T.@T@@TT..#.T@@@T.TT@#@T.@.#TTT.TTT@T.#T@T.@.TT@@T@TTT.T@@@.T@@@#..@@.@#@@.T..T@#@@.T#@T.@T..TT
@@T@@@@@T#.@T..TT.@@@TTTT@#T.@.T@T@@T@T...T.T#T@T@.@..@@.@T@.@TT..@.@T@@.@@T@T@#.@T.@.@TT@.T@#T.@.@TTTTT.T..@.@...T@T.T.TTTT.#TTT.#@@.T#@..@T@T.@.T#..@@T@T.#T.TT#..@TT@@T..T@T.@T#.@T
@..@TTT#@#.@..TT#T@@TT#@@T...@@#.TTTT..T.TT.TT@@T.T@.T.@T.@@@TT....@@TT@T.@.@TTT@T@@TTT@#@.T@@TT@T.@.T@@@@@T...T@..@@@@#T@@.##TT@..T...@@@@.@TT....@.@#@T@.@......TT..T.T#T@..@T@.@@.@
.T#TTT@TTT...@@#.TTTT#T#@..#TT#@T@..@...@TT@.@T@@T.#..@.@@@@@.#.#@#TT@@T..TT@.TT.TT...T#..@@TT@#T@T.@...#T@.#@.@T@@#T.T#.T..@@@T..@@.@T@.T.T.@.@#T.@#@T@T#@#T@..T@.TT.@.@.TT..T..T.@TT
@@.@..@@@#.T##T.@..T..@@#@@...TT#.T@..#.@@@@T@..TT@.T@..#@@TT.T.#@@@TTT.#T.TT.@T.#@@T@@#.#@@TT@T@T.@@.@..@TT.#@@@T@.@TT@.TT@TTT..@T#T.@T@#.T.TT@TTT.@.#@T...@TTT.T.@TT@@..#TT.@T..@#..
..T.#.T@.T#@@#.@TT@.TT@##@.TT@@TT.@#@@.TT@@@..@#@@@@.T.@.T.T..@T..#.#@@@T@@T.@#.##T#TT@.@#.T@T@.T@@.@.TT@T@..T#@.@..TT@@TTTT@..TT@.T@@@T#@#@@##@T.TTT.@@@T.@T@T.@.#.T@.@.#.@.TT#@.....
TTTTT@T.T#T@.#.@TT..@@.T@TT..T.T@.T@##TTT@@TTT@.TT..@.@@.##.#.#@TT@.@TT.@.TTTT.T..T..@T.TT.@TT.@T.T@.#..T@T.@TTTT.T.@#....@..TT.@TT@T#@.#...T#T.@@@TT.TT@TT@.T.@TTT#T.T@T..#T.T@T@T#@.
T@.T.T@@@.T@@T@TTT@@.#T#T@@..@T.@T#T@T@@.T..T.@T.TT.@@##@...@TT.T.T@.T@@.@T@@T@T@@TT.#@TT@@T@@.@@....@@T.@.@TTT.T@##@T.@.#.@TTT@@.@TT@@T.@@@@T@.TTT@#@.@#TTTT.T.T@T#@#..@.@TT.TTT@T#..
@@T@..T.T@TT@#T#.TT@@T.#....@@#T@.#.TT@@@..TT@@.T...@T#.@TTT.TTT.@T.T@T.#.T@.#T@T.T.#@@@.T..@T..T@..TT@..T@T.@TT@..T.T.@T@T@#TT.T...@@.#.@@.T@T.T.@.@@@..@...#.T..T@@@@TTT.@..@TT.T.@T
.TT@T@T#T@T@.#@#T#...@@T#@T@#.#@..@@T@@@.@.T@@T@@T#.T.TT#TTT@#.@TTT#.T.@.@.@#TTT..TT.TT.@T....TT.@TT#.T.@.@#.T.#TT#TT@.@#@T.T#@.T@.TTTT@@.#@#.T..T#T@.@T@@@.#@T.TTT.#T...@@.@.#T.T@T.#
#T@T.#TT.TT@@@.T..T..@#@T@....@TTT...@T.T@#TT.#@T..T@T..@TTT@@@..@#@T.@@TT@..@.TT@.T#T@.@T@TT..TTT#TT..T.T.@.#.#T.TTT@..#TTT.@@@@@T#.@TT@TT@@#.@@@..@.@@.#T.#TT@.@@...#@@@T.T@@T#T@..T
..@#T@@#T@@@#@.#@TT...T@T#TT.T.@T@T.@.T.....@TT.T@T.T..T@#@T@.@@T@.@#.@T@.@.T@..@@.TTTTT#.T#...@@TT.@@@@@..T@TTT@.T.#.T.T..@#T.T@.T.@@T@@@##@TTTT..T.@#T@TTTT.@.@.@@@#@T..@@T.@@.@#@..
TT.T@T....@T.@.@@.@..@.@@@..T....@TTT.T.@@..T.@T#T..T.@@....@@@@.#.T#@TT.T@.@T@T..T.TTTTTTT@@.@@.@@@T@T..@@@.@T..TTT..T@T@.T#.T.@@.@#TT@T@T#.TT.TT.TT@TTT#TT...@TTTT#@@@..T@.#@@@@@.T@
TTT@.#T@TT.#T@T.@@T@TTT@#..T@.T@@T.T@...T@T@#T.@TTTT@T.@@@#.TT@#..@T@T.@@@#..T@..#TT.T@.@@.@TT.T.@.TT.@T.@.@T@@.TT..#@T@TTT..@T@T.T@@@@@@@T#T.#.@T@..@.#..@@.@@@T#@@TT#TT...T..@#TT@@T
#..@@@T@@.T..@.#TT..#.#.#T..T....TT@...T.@#T.TT@@@.T@@#.TT#.TT@...@.@@@@.@@T.@.T@@T@...#.@T#@.#TT@T#..@.@@T@T@T@@#.#@TT#T@T..#@@TT#@@..@.@T#T.T@..@.#.@@.@T@@.T..#TTTTT#@.@TT#..T#.T.#
TT.T@@@@T.@T@@T@T@#.TTTTTT#.@TT.TT.T##......@@.@@@@TT.TT@.TTT.TT.T..##@@##T.T..@T@T@#T.TTT.@TTTT@..#T@T.T.@..@@@@.#@..@T@@.T@T.#..T#@.@@.@T.@.T.@TT.T@..TTTT@T.....@@.T@#@.TT#..@.##T@
TT.#T@T#.#@T.@.T..@T@T.@TTTT#...T@.@....@T.@.T.T@.@T@#...@.#.T.@#TT@.@#.@#T@.#@T@.T.T.#.T..T@@@.@.@@T@T@.T...T.@TT.TTT#.T.@@#T@#.@.@@.@T.T@@.TT.T@.T@@T@@@.#..##@T.@.@.@@..@#TTTT@#...
@@@.@.T##.T.#T#..T#@.@@.@.@@@TT.T@.T@.#TTT.TTT@.@T@#.@###.TT.TTT.TTT.@.T@#@#@.T@@T..TT@@@.TT.TT@T.T...T@.@.@@T@TT@T.@.@T..T#T@.@.#.TTT..#TTT..@@@@T.T#.T..@T@@T..#.@#T.@TT@#@T@@@..@.@
.TTT@TT@.@.TT@TT..@.#..T@...@T@@TT.@##T@TT@@@@..T.T@.#@TT@.TTT#.@@T@T.#.TT.@TTTT..@@T@TT@#T#TTTT#@T..T.TTT@.#@@TT.@#@..@@..TT@T.@@@@.@TTT.TT@TTT..@..#T@T@.T..@.T.T.@@.T.#@T.@T@#T#...
@@.T.T...@#.@T..T..T..@#...@@@TT.@...T@@TT.T#......T@#T##.T@..T@T@@T@@..T.T@..@#@..@.T@.TT...T@.@@#@@T...@@..#.@@.@@.@..TT@..T.@..TT.@.#@.T.@T#T@.....TT.T@...@.@T#TT.@@.T.@@TT#T@@@@@
.T#TTTT#T@@@@#.T#.TTT@......@TTT.T@@T.@.T.@..T.@T@@@@#T@T@...@.@T@@T@@@....@.TT.TTT#@T#..@.T...T@.T.T@.@@.@@#@T#@@TTT.T@T@@@@TT#T..@@.@@@.T#TT#T@..#@T#TTT@T@#.@@@@#T#.@T#T..T.T.@#@.@
#.#@T@.@@.T@@#T#.@T@@@T.@....#.@..@#...T.@@@@#..#TTT..T@TT.@@T.TTT.T@T@.##TTTTT.TT@.@#T..TTT.TTT@T.T.@T@TT@TT.@T@#@.T..@..#@T.T.@...@.#.....@TT@T.#...T@@T.@..@..TT.T#TT#.T@..T@@T@.##
@T..#.T@.@..#TT@#.@@TT@#T@.@...T...#..@T...T..T@.T.#T#.T.T.T...@.#.@.@@#.#.@..@#.@#@.@@@T@@#TTT@...@..@T@T@.@@##@@@T@.TTT@T@..T@@T@@@@@@.@TT@.@..TT##.T.@@@T@TTTT.@T.@.#@T@.@.T#TTT@@T
T@TTTT@T.#T....@..#@..@.T#@@T@...@TT#TTTT@T@@TT#.T.@...#..TT...@T.@@@.#@@T#@@.@#T.TT@@.T..@T.T..#TTT@..T@@#.T@..@@TT..T.@T.T.T.@T.T.@#T.T@##T#T.@#T@.@T.T.@T@#@T@@.TT@@#T...@.T....T@.
@@@T@TTTTT@@@@@.#TTT@TT@.@@@.@TTT.@@@.#TTT..T@TT#@TTT..T#@.T.@T.@@..#.@.T#.TT@.T@##T.#TT.TT.TT@TT@..T@@@.#T.TT...@@..TTT#TTTT.@.TT#..T@T@T@@T..T.T@T@.@#..@..T@#.#.@TT@###@T@@@.@.@.##
.@@@@TT@.T@TTT@.T.@@TT.#T#..@@T.T@.@T##T#T@T#T##TT@@#.TT#.#.T@#TT@.#..#..T@.T@TT.@@.T#@...#.T@@TTTTT@.#.#T#.T@TTT@@T#@@.@.TT#T.T.@@T@@@@.@#.#T#.#.T#@TT#@@TT@...#@T#T...T.@@@T@TT@T...
@#T@.T#T.T@T.T.#@...T@..TTTT@@@T.#.@T.#@@.T.@T@T.@.T.T@T.@T.TT@#@@@@@@@@#...@@@..TTT@TTT@.@T.T.TTT@TT.TT.@@.@T#@.@@.@@.@.##.T.#T@#.@.@..T@@.#.@@.TT.@@T@@@TT.TT.@@#@..@@.@TT.@TT@TT..T
T.@TTT@@.T@T@@@@.@.T@.T.@@@@T@@.@T.T#TTT##.T@.@##TT@.@@@TT.T@#T@T..TTT@T@@TT@#.@.TT@#TT@.@TT.#@.TT@.@TT#T@T.@.@T@@.T@......T.@@.@.@@TT@@@T@@T.@T@.T@TT.TT@T...T.@T@#.T.TT@#@#T@TT@TT.@
@TT@.#@T.@T#TT...T.T.@.T@@.T.@.T@T@.T@.@.#@@#T.##.TT.@@T@TT.@.@....T#@TTT...@T@T.@.T@T#@..#T@T@#@T@@T@@##@.TT@@T.TT..@T@T@#T.#@T.@T..TTT...#@.T@@#.@#.T@.T@TT.@#@@.@#@TT@.T@...@@#.@..
.T@.T.T@##@.#@.T@@#T.#@T..T....T..@T@.T.T@TTTT.@@@@@.@.T@T@.@TT.T@.@.T.@@.#T@TT@.#..T.@.T.TT@@.#@T@@@@T@@.T#@@.@@#.@TT@@@#@@T@@..TT.@@#.#T@@@.TT@#@#....TT.@T#.@.#TTT@@TT.TT@T@TT@.@.T
@@.T.##T@#..T@.#TT@@T..#.TT..T..@T.TT@.#@...TT@@..TT@.T.@##@.@#.T.T..@@T@..@#@.T..T@.T@T.T#T.@T.T.TT.T.@..@T.T@@.T@@.@.@TTT.@T#.@T..@.T.#..##@.TT@..@.TT.T.....#..TT@T@@.TT@@@T@TTTT.T
..@...TT#@#T@@@@TT..T.@@@T@@.T.#.@@#.T@T@@##@T.@@TT@#T@#@@.T..T@T.@@@T@TT@T.T@#..@..@..@@#.#T.@@TTT@T@@T@TT@.@@@@T#TT#@#@..@.@#@..T..T@@T..#@@T.T.@#.T..@.@T.#.TTT@.@TTT@@TTT@@@@...@T
.##@.@T.TTT#T@.T.#TT#@@@@TTTTT.@T.@T@.T#.TT@T@.T.@T.@@...@.@.@T.@.@T.@.T@@.T.#.@@.TT@T@.@@..#@T.@@.T.@T.TT#@@@@@..#T.#T#.T.@#@#@TT@@#..#@T##@#T@@#..@...T.@.T@..TT.@.T.TT..TT.@.T#T.#T
@..TT#.T.TT#..T@@@#@@@.T.@.T.#..@T.T@T.#@T...T.@TTT@T@TTT@T@@@@.T#.@.T#@.T@.TT.T.T#T@@.T@@@.@.T.@@.T@.@##@T@T@@T..@TT@@T@@T@.T.##.@.T@@@@#TT@.@.@.@.@@..@.TT@TTTTTTT@..@.T@@T.@.@TT#.T
#.T@#@.T..TT@T@@TT@T@T#TTT.TT.T...@.@#T.TTTT.@.@.T@#.#TT..@.T..#..@T.@#.@.@T@.@@.@#@T#T.T.@T.#T.T.@@T..T@T#..T@@.TTT@@.#.@@@@@.T@...#TT..TT.TTT.@..@T.#.T@T.@@@.#@@.@T@..T.@@....#.T..
.@.T@.TT@#.@T@@.T..@T#@T@.T.#T..@#TT.T@T@@..@#..T.T#TT.T.#.@@.T.@@T@T@..@...TTT..T.@.@@TTTT.TTT@@.@@..@#..TT@.T..T@@.T.T.T@T@.@T@..@.@@T.@T...@@.@T.@@.@T@@@T...@.T#T#@T@T.T@T.TTTT@.@
#..TT@.@@.@#@T...@.@T.@T.T@@@.@.@#.@..T.@@@@@@.@T@TTT..@.#T.T.@#@T@###.@#T#T@.##T@@.T@#T.T@.TT@@T.@@TT@@.@T@@..@@.@.@..@@@@TTT.T@TTT@@##T.@@T#@T#@@.@#.T@T.TT....TT@T.@@#.@.@T.@T@@@#@
TT@T.@@..TT#T@.TT..@.T@@@...T....T...T@TTT..@T.TT@.@T@@T.#@T#T@T@.T.#.T..@@.#.T...#..@@TT..T@@T..TT.@.@##@TTTT@T@@.@.@.@TTT#...TT@T@@@@@@T.T.@@T@#..#TT.T@..#@.TT@T@.@#@...#T.TTTT@TT@
...@..T..T..@@@#TT#.@...T##@.@..TTTT#@@.##@@.#T#.T@.TTTT.@@#.T@..@TT.@#T.@TT@.T.T.@.T#T#TT...TT##.T.#T@#.T.@@@@...T..TT.T....TT.@@.T@TT@..@@@@.TT@T@T.TTTT@#@TT.T.#@@@T#TT..T.@TT#@T..
.@T.T#T@.@@.@T.T@.#@@TT....@...@@@.T..@T.TTT..#@..@.TT.#T.@.#T.@@.@.@#..@T..T..T.T@TTT@.@#@T@TT##T@.TT.@@T.T@T.#@@@T@TT@.TTT.T@@TT@....@.@@@@.TT@T@.@T@T#T@.T#TTT.@#.T.TTT@TT.T.#@@@T@
#@@@#..TTT.T..T@T#TT.@.@TT.@T.T..T@T.@T.@TT@T.T.T.T.T@.TT@#T@@@T@.@T.T@.@.@.@..TT.@TTTT..T@@.TT.T@@@.@T.T...@.TT.#T@@T.@@@.@TT@.#@T.@.@T#.@T@T..T@T.@T.@T@..TT.....@@@.#@.@@T@@.@..T@.
TT@..T@TT.#TT@TTTTT..@#.T#@@@.@T@#.@TT@T@@.T..##@@.T.@T.T...TT.TT@TT#T.T#.@T.T.@.@.@@.T@@@..T@T..TT#.@T..TT@T@@.T@T@T.T.@@@@.@.T@@T@@@#T@.T@.#T@.@T@T@.@@@@#..T@.T@#@@#@TT@.@TT.@@@.T@
.@#T@@T##T#@@.T@.T#TT#TT..@#.T#@@@@TT#@T..@@#T..T@TTTT#T.#T.#TT@@#.TT@@@#@@@..#T.T...T@@@.T@@TT@@.@@TT@@@T.T#..T@#..@..@#T@.@@T.@#..@@TTTT@.T#@@@.@.T.#@.@@T.@..T.TTTTTTTT.@..T@.TT@@T
T.@#.#TT@TTT@.T..T@T@...T..TT@@T@.T@@.@T.T@@#T..@@...@@@#.@.T.@T@.@@T##.TTTT@#T@@T@@..@T.TT@T@.T.@TT@T#.TTT#..T..T.@T..@#..@@T@.@.@@@T@@.@.@#.@#T#..T.@T@@.@.T.TT#.@@.T.@T@TT@@T@TTT.T
TT.@.@@.T..#T..T@.@T@.@.@T@TT.@#T.@T.T#T...T@TT@@T@.T...T.@..@.#.@@T.T#T#.T..T@#.T##TT..@@...@.T@...T..##.@.@@@T@@.@.@.T#.T###@@.@T.@.#T#..@...@..@#..T@.T@.T.@TTT..@@.T.T.T@..#T....#
@.@.T.#@#@..T@TTT@@T.@@@.T@.T..@T#.T.T@TT@.#..T..@T..@T@@#@#@.#@@#T@.T.T@TT@T@T#@T@@@@@@..#@TT.T.T.@T.@T@.#@@.#.@@T#.#.T@@T@...@T#T#@...##@#@T@...TT.#..@T@@@.T.T#@.T@T.#@TT.#.#@T@.@@
##@#@.T.@@@T@T.@@@#.T@#T#@T@@TT#TT##@@T.@T.T@...TT#@@@.T@T.TT##T.#.@TT....#..@T#T.T...TT#@@T.#@@@T##T.@@#@T@@..#TTT...T.#@.@T@@T.@..@@@@@TT@..@..@.T.@.TT@T@@T..@T...@T.TT.T#T.T..@..@
#.@#T.T.T.#T@T@@@@T#.@.T@@T@.@..TT.T@@.@@@@..T@@@..TTTT.T.T##@@T@@#@@@TT@#T.T@TT.@@.@T..TT@@#T.@@@T.T.@.TTT#..@T..##@T@..@.#@T#@T#.@#TT..##T.@TTT.TT.T.@.@.T.@..@.@.TTT@@@@#.T@@#T@T.@
.##.T@@#TTT@T@@..@.@@T#@@@@...T@@T##..TTTTTT@#TT#....TTTT..@.@.T...T.#@.T.@.@TTT@@.T..@TT.#.@#T@@.T@T@.T@@..@...@@T..#@#.#..@@@.T#....#@..@.T...#@T@T.@@.T.T.@T@@.@...@...T@TT#TT#T.@@
.T@@T.@.TTT.T.#...#TT.@T@@T@T#.T@.#T##@@@.@@#T.#TTTT@@T@.@.@@T.T@..T@T..#@TT.TT.@.T@#.#@.T.@...@T#@..TT.#T.@.@.@@@TT#.TT.TT#.@.@@#T@@T....T.@#@@@T.T#T@T@#T@TT@.#T#.TTT@..T@@.T..T@@@.
@@.@@T...#.#@T.#T#.T#.TTTT@T@@##@#@@..T@.@@#@@T@..T@..T@@T@@#.TT.@T..TT@T@.@@..TTTTT.T@T.TT@T@TT.@@TT.@@@.T.@#.T.@@@#T.@@.@@.T#@@T.@..TT..@T.@T.@.T@TT@.@##@#T#.@T.@@@@.@@T@T.@.@@T#.@
..@@T@TT#@@.T..#@..T#@.@..@@..@.T@@TT.T.@@@..TT@TTTT@@@TT..#@@.T@T..@T.T.@.T@..T#@T@@T.T@@T.@T@T..T.@TT.#.@T..T.T#TTT.#..@@.T@@#.TT.TT.@.T@TT@.##T@.@T#@@T.#..@@@.T.T.T@@@.@@.TT.@@.TT
@@T@@#..@.T#@@...T.T.@@@#.@@.T#@.@...TT@.@@T.TT@..#.@#T.#T@@@.T.#@T..@@.@T@T.@T.TT@@.#T.T#@@T@.@@#.@TT.###T.T#T#T@TT@..@@.T..TT@.@.#.@@T.T@T@#@#.@T@.#TTT#@.#.@#@...@T.#.T.#TT@@.T@TT.
@@.@.T@@T.@...@T.TTTT@@..@.@#T.@@#@TT@T@.TT#.#@@TT@T#.TTT#..@TTT..#T@T#.@.@@@T@@TT#@@@.T@T@.@.TT....#@T@#@...T##.@.T@@...TT@.#@#.@.@..T.@T.@T#TT...T@.@@@@....T#T@@@.T@###.@T#T@#T.@T@
@@T@@..@.TT@#@@###.@@T@TT@.@T@@TTT@@.@@.T@.@@T@.@#@..@..@#..#T.T@T.@...##.TT#.#@TTT@TT....T@@T.TT.@@T@..T@T@...T#@TT.#T@..@T#@T@T@@@T@..T@@T@..@.#T@@.#TT.@T@.#.@@T@...@T#.@@T.@.#@#.@
